#####################
#   #     #         #
### # # # ### ### # #
#   # # #   #   # # #
# ### # ### ### # ###
# #   # #   #   #   #
# # ### # ### ##### #
#   #   #   # #     #
# ### ##### # # ### #
#   #   # # # # # # #
### ### # # ### # # #
# # # # #       # # #
# # # # ### ##### # #
# #   #   # #   # # #
# ### ### ### # # # #
#       #     # # # #
# ######### ### # # #
# #   #   #   # # # #
### # # # ##### # # #
#   #   #       #   #
#####################
