#########################################
#   #         #       #       #     #   #
# ### # ##### # ##### # ##### # # # # # #
# #   #   #     #     # #   #   # #   # #
# # ##### ######### ### # # ##### ##### #
# # #   # #       # #   # # #   #   # # #
# # # # # # ##### # # ### ### # ### # # #
# # # # # #   # # # # #       #   # #   #
# # # ### ### # # ### ######### ### # ###
#   # #     #   #   #     #     #   #   #
# ### # ####### ### ##### # ##### ##### #
#   # #         #       # #   #   #   # #
### # ########### ####### ### # ### # ###
#   # #         #     #   #   #     #   #
# ### # ####### ##### # ### # ######### #
#     # #     #     #   #   # #     #   #
# ##### # ######### # ##### # ##### # ###
# #     #       #   # #     #       #   #
# # ##### ### # # ### # ########### ### #
# # #   # # # # # #     #     #       # #
# # # # # # # # # ####### ##### ####### #
# # # # #   # # #       #     #   #     #
### # # # ### # ####### # ### # ### ### #
#   # # # #   #   #     # # #   #   #   #
# ### # # # ####### ##### # ##### ### ###
# #   # # # #       #   #       # #     #
# # ### # # # ####### # ##### ### ##### #
#   #   # #   #       #     # #   #   # #
# ### ### ######### ####### # # # # # ###
#   #   #   #     #     #   # # # # #   #
### ### ### # ### ##### ##### # ### ### #
# # # # #     #       #   #   #       # #
# # # # ### ######### # # # ########### #
# # # #   # #   #     # #       #     # #
# # # ### ### # # ##### ######### ### # #
#       #     # # #     #       #   # # #
# ######### ### # ##### # ##### # # # # #
# #   #   #   # #     # # #   # # # #   #
### # # # ##### ##### ### # ### ### ### #
#   #   #       #         #         #   #
#########################################
