#############################################################
#     #             #         #   #           #             #
# ### # ######### # # ##### ### # # ####### ### # ######### #
#   #     #       # #     #   # # #   #   # #   #   # #   # #
######### # ##### ##### ##### # # ### ### # # ##### # # # # #
#   #   # # #   # #     #   # # #   #     #     # # #   # # #
# # # # # # # # ### ##### # # # # ####### ##### # # ##### # #
# #   # # #   # #   #   # #   # #         #   #   #     #   #
# ##### ##### # # ##### # ##### ########### # ### ##### # ###
# #   #     # # # #     #       # #       # #   # #     #   #
# ### ##### ### # ### ########### # ### # # ### ### ####### #
#   #     #     #   #       #       #   # #   #     #     # #
# # # # ### ####### ##### # # ####### ### ### ####### ### # #
# # # # #   #       #   # # # # #     #     # #     #   # # #
# # ### # ### ####### # # ### # # ########### # ### # # # # #
# #   #   # #   #     # #   #   # #           # #   # # # # #
# ### # ### ### # ##### ### ### # # ########### ### # # # # #
# #   #     # # # # #   #   #   # # #   #         # # # # # #
# # ####### # # # # # ### ### ### # # ### ####### ### # ### #
# # #     # # # # #   # #     #   # #     #     #     #     #
# # ##### # # # # # ### # ##### ### # ##### ### # ###########
# #     #   # #   #   # #     # #   # #     #   #         # #
# ##### # ### ####### # ### ### # # ### ##### ########### # #
# #   # #   #       # #     #   # # #   #   #       #   # # #
### # # ### # ####### ##### # # # # # ### ######### # # # # #
#   #   # # #     #   #   # # # # # # #           #   # #   #
# ####### # ##### # ### # ### ### # # ##### ##### ##### ### #
#   #     #     # #     #     #   # # #     #     #   #   # #
### # # ####### # ########### # ##### # ##### ####### ### # #
#   # #               #     # #     # # #   # #     #   # # #
# # ################### # ### ##### # # # ### # # # # ### # #
# # #                 # #   #   #   #   #     # # #   #   # #
# ### ########### ### # ### ### # ####### ####### ##### ### #
# #   #         #   # # #   #   #       # #       #     # # #
# # ### ####### ##### # # ### ######### # # ####### ##### # #
#     # #     #     #   #   # #     # #     #     # # #     #
# ##### # ######### # ##### # # # # # ####### ### # # # #####
# #     #       #   #   #   # # # #       #   # # # # # #   #
# # ##### ### # # ##### # ### # # ####### # ### # # # # # ###
# # #   # # # # # #     #     # # #       # #   #   # # #   #
# # # # # # # # # ####### ####### # ####### # ####### # ### #
# # # # #   # # #       #   #   # #   #     #         #     #
### # # # ### # ####### ### # # # # ### ##### ####### ##### #
#   # # # #   #   #     #   # #   # #   #     # #   #     # #
# ### # # # ####### ##### ### ##### # ### ##### # # # ### # #
# #   # # # #       #   #   # # #   # #         # #   # # # #
# # ### # # # ######### ### # # # ### # ######### ##### # # #
#   #   # #   #           #   # # #   #   #   #   # #   # # #
# ### ### ######### # ######### # # ####### # # ### # # # # #
#   #   #   #     # #   #     #   # #     # #   #     #   # #
### ### ### # ### ##### # ### # ### # ### # # ############# #
# #   # #     #       # # # # #   #   #   # # #   #       # #
# ### # ### ######### # # # # # ####### ### ### # # ##### # #
#   # #   # #   #     #     #   #     # #     # #   #     # #
# # # ### ### # # ##### ######### ### # ##### # ##### ##### #
# #     #     # # #     #       #   # #     #       # #   # #
# ######### ### # ##### # ##### # # # ##### ####### # # # # #
# #   #   #   # #     # # #   # # # #     #   #     #   #   #
### # # # ##### ##### ### # # # ### ##### ### # #############
#   #   #       #         # #       #         #             #
#############################################################
